可	a;
对	b;
好	c;
不	d;
的	e;
一	f;
大	g;
到	h;
没	i;
是	j;
上	k;
中	l;
小	m;
回	n;
为	o;
这	p;
我	q;
得	r;
在	s;
人	t;
着	u;
了	v;
然	w;
出	x;
心	y;
嗯	ln;
吗	lx;
和	rl;
爱	ey;
就	om;
